..#.....#..s
#..#...#..#.
#.#######.#.
###.###.###.
###########.
.#########..
..#.....#...
.#.......#..
............
..#.....#...
...#...#....
..#######...
.##.###.##..
###########.
#.#######.#.
#.#.....#.#.
...##.##...e
