s########.
.##.##.#..
.......#.#
###.##.#.#
....#.....
.#.###.#.#
#...#.....
###...###.
..##.##.##
#........e
