s...............
.....#####......
...#########....
..###########...
.####..####..#..
.####..####..#..
###########...#.
##########....#.
#########.....#.
########......#.
####..........#.
###...........#.
.##....##....#..
.##....##...##..
..##.......##...
...###....##....
.....#####.....e
